______________________________________________________________________________________________________________________________
______________________________________________________________________________________________________________________________
______________________________________________________________________________________________________________________________
______________________________________________________________________________________________________________________________
______________________________________________________________________________________________________________________________
______________________________________________________________________________________________________________________________
______________________________________________________________________________________________________________________________
______________________________________________________________________________________________________________________________
_______________________________________________________________________________________________________------_________________
_____________________________________________________________________________________________________-----------______________
____________________________________________________________________________________________________--------------____________
____________________________________________________________________________________________________------*--------___________
______________________________________________________________________________________________________________________________
_________________________________________________________________________________________________________SSS__________________
________________________________________________________________________C__________________________C_____SSS__________________
_________________________________________________________________________________________________________SSS__________________
_________________________________________G__________G_________HHHHHHHH__S__HHHHHHHHHH__SSS_________S_____SSS__________________
______________________________________________________________HHHHHHHH__S__HHHHHHHHHH__SSS_________S_____SSS__________________
______________________________________SSSSSSSSSSSSSSSSSSSSSS__HHHHHHHH__S__HHHHHHHHHH__SSS_________S_____SSS__________________
______________________________________SSSSSSSSSSSSSSSSSSSSSS__HHHHHHHH__S__HHHHHHHHHH__SSS_________S_____SSS__________________
________________________________________________________SSSS__HHHHHHHH__S__HHHHHHHHHH__SSS_________S_____SSS__________________
___________________________________________HHHHHHHHHHHH_SSSS____________S______________SSS_________S_____SSS__________________
___________________________________________HHHHHHHHHHHH_SSSSSSSSSSSSSSSSSSSSSSSSSSSSSSSSSSSSSSSSSSSSSSSSSSSSSSSSS_____________
___________________________________________HHHHHHHHHHHH_SSSSSSSSSSSSSSSSSSSSSSSSSSSSSSSSSSSSSSSSSSSSSSSSSSSSSSSSS_____________
___________________________________________HHHHHHHHHHHH_SSSS___________________________SSS____________________________________
___________________________________________HHHHHHHHHHHH_SSSS__HHHHHHHHHHHHHHHHHHHHHHH__SSS____________________________________
________________________________________________________SSSS__HHHHHHHHHHHHHHHHHHHHHHH__SSS____________________________________
_____________________________________________C_SSSSSSSSSSSSS__HHHHHHHHHHHHHHHHHHHHHHH__SSS____________________________________
________________________________________________________SSSS__HHHHHHHHHHHHHHHHHHHHHHH__SSS____________________________________
________________________________________________________SSSS__HHHHHHHHHHHHHHHHHHHHHHH__SSS____________________________________
________________________________________________________SSSS__HHHHHHHHHHHHHHHHHHHHHHH__SSS____________________________________
_______________________________________________________________________________________SSS____________________________________
______________________________________________________________________________________________________________________________
______________________________________________________________________________________________________________________________
______________________________________________________________________________________________________________________________
______________________________________________________________________________________________________________________________
______________________________________________________________________________________________________________________________
______________________________________________________________________________________________________________________________
______________________________________________________________________________________________________________________________
______________________________________________________________________________________________________________________________
______________________________________________________________________________________________________________________________
______________________________________________________________________________________________________________________________
______________________________________________________________________________________________________________________________
______________________________________________________________________________________________________________________________
______________________________________________________________________________________________________________________________
______________________________________________________________________________________________________________________________
______________________________________________________________________________________________________________________________
______________________________________________________________________________________________________________________________
______________________________________________________________________________________________________________________________
______________________________________________________________________________________________________________________________
______________________________________________________________________________________________________________________________
______________________________________________________________________________________________________________________________
______________________________________________________________________________________________________________________________
______________________________________________________________________________________________________________________________
______________________________________________________________________________________________________________________________
______________________________________________________________________________________________________________________________
______________________________________________________________________________________________________________________________

