____________________________________________________________________________________________________________________________________________________________________________________________________
____________________________________________________________________________________________________________________________________________________________________________________________________
____________________________________________________________________________________________________________________________________________________________________________________________________
____________________________________________________________________________________________________________________________________________________________________________________________________
____________________________________________________________________________________________________________________________________________________________________________________________________
____________________________________________________________________________________________________________________________________________________________________________________________________
____________________________________________________________________________________________________________________________________________________________________________________________________
____________________________________________________________________________________________________________________________________________________________________________________________________
_______________________________________________________________________________________________________------_______________________________________________________________________________________
_____________________________________________________________________________________________________-----------____________________________________________________________________________________
____________________________________________________________________________________________________--------------__________________________________________________________________________________
____________________________________________________________________________________________________------*--------_________________________________________________________________________________
____________________________________________________________________________________________________________________________________________________________________________________________________
_________________________________________________________________________________________________________SSS________________________________________________________________________________________
________________________________________________________________________C__________________________C_____SSS________________________________________________________________________________________
_________________________________________________________________________________________________________SSS________________________________________________________________________________________
_________________________________________M__________M_________HHHHHHHH__S__HHHHHHHHHH__SSS_________S_____SSS________________________________________________________________________________________
______________________________________________________________HHHHHHHH__S__HHHHHHHHHH__SSS_________S_____SSS________________________________________________________________________________________
______________________________________SSSSSSSSSSSSSSSSSSSSSS__HHHHHHHH__S__HHHHHHHHHH__SSS_________S_____SSS________________________________________________________________________________________
______________________________________SSSSSSSSSSSSSSSSSSSSSS__HHHHHHHH__S__HHHHHHHHHH__SSS_________S_____SSS________________________________________________________________________________________
________________________________________________________SSSS__HHHHHHHH__S__HHHHHHHHHH__SSS_________S_____SSS________________________________________________________________________________________
___________________________________________HHHHHHHHHHHH_SSSS____________S______________SSS_________S_____SSS________________________________________________________________________________________
___________________________________________HHHHHHHHHHHH_SSSSSSSSSSSSSSSSSSSSSSSSSSSSSSSSSSSSSSSSSSSSSSSSSSSSSSSSS____C______________________________________________________________________________
___________________________________________HHHHHHHHHHHH_SSSSSSSSSSSSSSSSSSSSSSSSSSSSSSSSSSSSSSSSSSSSSSSSSSSSSSSSS___________________________________________________________________________________
___________________________________________HHHHHHHHHHHH_SSSS___________________________SSS__________________________________________________________________________________________________________
___________________________________________HHHHHHHHHHHH_SSSS__HHHHHHHHHHHHHHHHHHHHHHH__SSS_____C____________________________________________________________________________________________________
________________________________________________________SSSS__HHHHHHHHHHHHHHHHHHHHHHH__SSS__________________________________________________________________________________________________________
_____________________________________________C_SSSSSSSSSSSSS__HHHHHHHHHHHHHHHHHHHHHHH__SSS__________________________________________________________________________________________________________
________________________________________________________SSSS__HHHHHHHHHHHHHHHHHHHHHHH__SSS__________________________________________________________________________________________________________
________________________________________________________SSSS__HHHHHHHHHHHHHHHHHHHHHHH__SSS__________________________________________________________________________________________________________
________________________________________________________SSSS__HHHHHHHHHHHHHHHHHHHHHHH__SSS__________________________________________________________________________________________________________
_______________________________________________________________________________________SSS__________________________________________________________________________________________________________
____________________________________________________________________________________________________________________________________________________________________________________________________
____________________________________________________________________________________________________________________________________________________________________________________________________
____________________________________________________________________________________________________________________________________________________________________________________________________
____________________________________________________________________________________________________________________________________________________________________________________________________
____________________________________________________________________________________________________________________________________________________________________________________________________
____________________________________________________________________________________________________________________________________________________________________________________________________
____________________________________________________________________________________________________________________________________________________________________________________________________
____________________________________________________________________________________________________________________________________________________________________________________________________
____________________________________________________________________________________________________________________________________________________________________________________________________
____________________________________________________________________________________________________________________________________________________________________________________________________
____________________________________________________________________________________________________________________________________________________________________________________________________
____________________________________________________________________________________________________________________________________________________________________________________________________
____________________________________________________________________________________________________________________________________________________________________________________________________
____________________________________________________________________________________________________________________________________________________________________________________________________
____________________________________________________________________________________________________________________________________________________________________________________________________
____________________________________________________________________________________________________________________________________________________________________________________________________
____________________________________________________________________________________________________________________________________________________________________________________________________
____________________________________________________________________________________________________________________________________________________________________________________________________
____________________________________________________________________________________________________________________________________________________________________________________________________
____________________________________________________________________________________________________________________________________________________________________________________________________
____________________________________________________________________________________________________________________________________________________________________________________________________
____________________________________________________________________________________________________________________________________________________________________________________________________
____________________________________________________________________________________________________________________________________________________________________________________________________
____________________________________________________________________________________________________________________________________________________________________________________________________
____________________________________________________________________________________________________________________________________________________________________________________________________

