____________________________________________________________________________________________________
____________________________________________________________________________________________________
____________________________________________________________________________________________________
____________________________________________________________________________________________________
____________________________________________________________________________________________________
____________________________________________________________________________________________________
__________FF________________________________________________________________________________________
_________FFFF_______________________________________________________________________________________
__________BB________________________________________________________________________________________
__________BB________________________________________________________________________________________
__________BB_________________________CCCC___________________________________________________________
_____________________________________CCCC___________________________________________________________
_____________________________________CCCCCCCCCCCC___________________________________________________
_____________________________________CCCCCCCCCCCC__________DD__________________DD___________________
_____________________________________________CCCC________DDOODD____DDDDDD____DDOODD_________________
_____________________________________________CCCC________DDUUOOUUUUOODDOOUUUUOOUUDD_________________
_____________________________________________CCCC________UUUUOOUUUUUUDDUUUUUUOOUUUU_________________
_____________________________________________CCCC________OOUUOOUUUUDDDDDDUUUUOOUUOO_________________
_________________________________________________________SSSSOOUUUUDDDDDDUUUUOOSSSS____________________
_____________________________________________________________DDUUOODDDDDDOOUUDD_____________________
_______________________________________________________________DDDD______DDDD__________________________
____________________________________________________________________________________________________
____________________________________________________________________________________________________
____________________________________________________________________________________________________
____________________________________________________________________________________________________